33	50
31	8	9	9	9	9	27	8	9	9	9	9	10	8	9	9	9	9	10	8	9	9	9	9	10	8	9	9	9	9	10	8	9	9	9	9	10	8	9	9	9	9	27	29	9	9	9	9	27	32
31	11	17	17	17	17	28	11	18	19	19	20	12	11	17	17	17	17	12	11	18	19	19	20	12	11	17	17	17	17	12	11	18	19	19	20	12	11	17	17	17	17	28	30	18	19	19	20	28	32
31	11	16	16	16	41	12	11	21	22	22	23	12	11	40	16	16	40	12	11	21	22	22	23	12	11	16	41	41	16	12	11	21	22	22	23	12	11	16	16	16	16	12	11	21	38	39	23	12	32
31	11	16	16	16	42	12	11	24	25	25	26	12	11	16	16	16	16	12	11	24	25	25	26	12	11	16	42	42	16	12	11	24	25	25	26	12	11	16	16	16	16	12	11	24	25	25	26	12	32
31	13	15	15	15	15	14	13	15	15	15	15	14	13	15	15	15	15	14	13	15	15	15	15	14	13	15	15	15	15	14	13	15	15	15	15	14	13	15	15	15	15	14	13	15	15	15	15	14	32
31	1	1	1	1	1	1	1	1	1	1	1	1	1	1	1	1	1	1	1	1	1	1	1	1	1	1	1	1	1	1	1	1	1	1	1	1	1	1	1	1	1	1	1	1	1	1	1	1	32
31	1	1	1	1	1	1	1	1	1	1	1	1	1	1	1	1	1	1	1	1	1	1	1	1	1	1	1	1	1	1	1	1	1	1	1	1	1	1	1	1	1	1	1	1	1	1	1	1	32
31	1	1	1	1	1	1	1	1	1	1	1	1	1	1	1	1	1	1	1	1	1	1	1	1	1	1	1	1	1	1	1	1	1	1	1	1	1	1	1	1	1	1	1	1	1	1	1	1	32
31	1	1	1	2	3	1	1	1	1	1	1	1	1	1	1	1	1	1	1	1	1	1	1	1	1	1	1	1	1	1	1	1	1	1	1	1	1	1	1	1	1	1	1	1	2	1	1	1	32
31	1	1	1	2	3	1	3	1	1	1	1	1	1	1	1	1	1	1	1	1	1	1	1	1	1	1	1	1	1	1	1	1	1	1	1	1	1	1	1	1	1	1	1	2	3	1	1	1	32
31	1	1	1	2	1	3	1	1	1	1	1	1	1	1	1	1	1	1	1	1	1	1	1	1	1	1	1	1	1	1	1	1	1	1	1	1	1	1	1	1	1	1	1	3	3	1	1	1	32
31	1	1	1	1	1	1	1	1	1	1	1	1	1	1	1	1	1	1	1	1	1	1	1	1	1	1	1	1	1	1	1	1	1	1	1	1	1	1	1	1	1	1	1	1	1	3	1	1	32
31	1	1	1	1	1	1	1	1	1	1	1	1	1	1	1	1	1	1	1	1	1	1	1	1	1	1	1	1	1	1	1	1	1	1	1	1	1	1	1	1	1	1	1	1	1	1	1	1	32
33	56	57	57	57	58	34	34	34	34	34	34	34	34	34	34	34	34	34	34	34	34	34	34	34	34	34	34	34	35	1	1	1	1	1	1	1	1	1	1	1	1	1	1	1	1	1	1	1	32
-1	50	51	51	51	52	-1	-1	-1	-1	-1	-1	-1	-1	-1	-1	-1	-1	-1	-1	-1	-1	-1	-1	-1	-1	-1	-1	-1	31	1	1	1	1	1	1	1	1	1	1	1	1	1	4	5	1	1	1	1	32
-1	-1	-1	-1	-1	-1	-1	-1	-1	-1	-1	-1	-1	-1	-1	-1	-1	-1	-1	-1	-1	-1	-1	-1	-1	-1	-1	-1	-1	31	1	1	1	1	1	1	1	1	1	1	1	1	1	6	7	1	1	1	1	32
-1	-1	-1	-1	-1	-1	-1	-1	-1	-1	-1	-1	-1	-1	-1	-1	-1	-1	-1	-1	-1	-1	-1	-1	-1	-1	-1	-1	-1	31	1	1	1	1	1	1	1	1	1	1	1	1	1	1	1	1	1	1	1	32
-1	-1	-1	-1	-1	-1	-1	-1	-1	-1	-1	-1	-1	-1	-1	-1	-1	-1	-1	-1	-1	-1	-1	-1	-1	-1	-1	-1	-1	31	1	1	1	1	1	1	1	1	1	1	1	1	1	1	1	1	1	1	1	32
-1	-1	-1	-1	-1	-1	-1	-1	-1	-1	-1	-1	-1	-1	-1	-1	-1	-1	-1	-1	-1	-1	-1	-1	-1	-1	-1	-1	-1	31	1	1	1	1	1	1	1	1	1	1	1	1	1	1	1	1	1	1	1	32
-1	-1	-1	-1	-1	-1	-1	-1	-1	-1	-1	-1	-1	-1	-1	-1	-1	-1	-1	-1	-1	-1	-1	-1	-1	-1	-1	-1	-1	31	1	1	1	1	1	1	1	1	1	1	1	1	1	1	1	1	1	1	1	32
-1	-1	-1	-1	-1	-1	-1	-1	-1	-1	-1	-1	-1	-1	-1	-1	-1	-1	-1	-1	-1	-1	-1	-1	-1	-1	-1	-1	-1	31	1	1	1	1	1	1	1	1	1	1	1	1	1	1	1	1	1	1	1	32
-1	-1	-1	-1	-1	-1	-1	-1	-1	-1	-1	-1	-1	-1	-1	-1	-1	-1	-1	-1	-1	-1	-1	-1	-1	-1	-1	-1	-1	31	1	1	1	1	1	1	1	1	1	1	1	1	1	1	1	1	1	1	1	32
-1	-1	-1	-1	-1	-1	-1	-1	-1	-1	-1	-1	-1	-1	-1	-1	-1	-1	-1	-1	-1	-1	-1	-1	-1	-1	-1	-1	-1	31	1	1	1	1	1	1	1	1	1	1	1	1	1	1	1	1	1	1	1	32
-1	-1	-1	-1	-1	-1	-1	-1	-1	-1	-1	-1	-1	-1	-1	-1	-1	-1	-1	-1	-1	-1	-1	-1	-1	-1	-1	-1	-1	31	1	1	1	1	1	1	1	1	1	1	1	1	1	1	1	1	1	1	1	32
-1	-1	-1	-1	-1	-1	-1	-1	-1	-1	-1	-1	-1	-1	-1	-1	-1	-1	-1	-1	-1	-1	-1	-1	-1	-1	-1	-1	-1	31	1	1	1	1	1	1	1	1	1	1	1	1	1	1	1	1	1	1	1	32
-1	-1	-1	-1	-1	-1	-1	-1	-1	-1	-1	-1	-1	-1	-1	-1	-1	-1	-1	-1	-1	-1	-1	-1	-1	-1	-1	-1	-1	31	1	1	1	1	1	1	1	1	1	1	1	1	1	1	1	1	1	1	1	32
-1	-1	-1	-1	-1	-1	-1	-1	-1	-1	-1	-1	-1	-1	-1	-1	-1	-1	-1	-1	-1	-1	-1	-1	-1	-1	-1	-1	-1	31	1	1	1	1	1	1	1	1	1	1	1	1	1	1	1	1	1	1	1	32
-1	-1	-1	-1	-1	-1	-1	-1	-1	-1	-1	-1	-1	-1	-1	-1	-1	-1	-1	-1	-1	-1	-1	-1	-1	-1	-1	-1	-1	31	1	1	3	3	1	1	1	1	1	1	1	1	1	1	1	1	1	1	1	32
-1	-1	-1	-1	-1	-1	-1	-1	-1	-1	-1	-1	-1	-1	-1	-1	-1	-1	-1	-1	-1	-1	-1	-1	-1	-1	-1	-1	-1	31	1	1	1	3	1	1	1	1	1	1	1	1	1	1	1	1	1	1	1	32
-1	-1	-1	-1	-1	-1	-1	-1	-1	-1	-1	-1	-1	-1	-1	-1	-1	-1	-1	-1	-1	-1	-1	-1	-1	-1	-1	-1	-1	31	1	1	1	1	1	1	1	1	1	1	1	1	1	1	1	1	1	1	1	32
-1	-1	-1	-1	-1	-1	-1	-1	-1	-1	-1	-1	-1	-1	-1	-1	-1	-1	-1	-1	-1	-1	-1	-1	-1	-1	-1	-1	-1	31	1	1	1	1	1	1	1	1	1	1	1	1	1	1	1	1	1	1	1	32
-1	-1	-1	-1	-1	-1	-1	-1	-1	-1	-1	-1	-1	-1	-1	-1	-1	-1	-1	-1	-1	-1	-1	-1	-1	-1	-1	-1	-1	33	34	34	34	34	34	34	34	56	57	57	57	58	34	34	34	34	34	34	34	59
-1	-1	-1	-1	-1	-1	-1	-1	-1	-1	-1	-1	-1	-1	-1	-1	-1	-1	-1	-1	-1	-1	-1	-1	-1	-1	-1	-1	-1	-1	-1	-1	-1	-1	-1	-1	-1	50	51	51	51	52	-1	-1	-1	-1	-1	-1	-1	-1
