38	37
-1	-1	-1	-1	-1	-1	-1	-1	-1	-1	-1	-1	-1	-1	-1	-1	-1	-1	-1	-1	-1	-1	-1	-1	-1	-1	-1	-1	-1	-1	-1	-1	-1	-1	-1	-1	-1
-1	-1	-1	-1	-1	3	3	5	-1	-1	-1	-1	-1	-1	-1	30	3	3	5	-1	-1	-1	-1	-1	-1	-1	-1	-1	-1	-1	-1	-1	-1	-1	-1	-1	-1
-1	-1	-1	28	29	2	2	4	3	3	3	3	3	5	-1	29	2	2	4	5	-1	30	3	5	-1	-1	-1	-1	-1	-1	-1	-1	-1	-1	-1	-1	-1
-1	-1	30	29	1	1	1	1	2	2	2	2	2	4	3	23	1	1	1	4	3	29	2	4	5	-1	-1	-1	-1	-1	-1	-1	-1	-1	-1	-1	-1
-1	28	29	1	1	1	1	1	1	1	1	1	1	1	2	1	1	1	1	1	2	1	1	1	4	3	3	5	0	-1	-1	-1	-1	-1	-1	-1	-1
-1	24	23	1	1	1	1	1	1	1	1	1	1	1	1	1	1	1	1	1	1	1	1	1	1	1	1	4	6	-1	-1	-1	-1	-1	-1	-1	-1
-1	24	23	1	1	1	1	1	1	1	1	1	1	1	1	1	1	1	1	1	1	1	1	1	1	1	1	7	8	-1	-1	-1	-1	-1	-1	-1	-1
-1	25	19	61	61	1	1	1	1	1	1	1	1	1	1	1	1	1	1	1	1	1	1	1	1	1	1	1	4	6	-1	-1	-1	-1	-1	-1	-1
-1	26	20	16	16	23	1	1	1	1	1	1	1	1	1	1	1	1	1	1	1	1	1	1	1	1	1	1	7	8	-1	-1	-1	-1	-1	-1	-1
-1	-1	43	41	41	23	1	1	1	1	1	1	1	1	1	1	1	1	1	1	1	1	1	1	1	1	1	1	7	8	-1	-1	-1	-1	-1	-1	-1
-1	-1	-1	-1	42	23	1	1	1	1	1	1	1	1	1	1	1	1	1	1	1	1	1	1	1	1	1	1	7	8	-1	-1	-1	-1	-1	-1	-1
-1	-1	-1	-1	48	23	1	1	1	1	1	1	1	1	1	1	1	1	1	1	1	1	1	1	1	1	1	1	7	8	-1	-1	-1	-1	-1	-1	-1
-1	-1	-1	-1	48	23	1	1	1	1	1	1	1	1	1	1	1	1	1	1	1	1	1	1	1	1	1	1	7	8	-1	-1	-1	-1	-1	-1	-1
-1	-1	-1	-1	47	19	61	61	61	61	61	61	61	61	61	61	61	61	61	1	1	1	1	1	1	1	1	1	9	10	-1	-1	-1	-1	-1	-1	-1
-1	-1	-1	-1	46	20	16	16	16	16	16	16	16	16	16	16	16	16	16	19	61	1	1	1	1	1	1	7	11	12	-1	-1	-1	-1	-1	-1	-1
-1	-1	-1	-1	1	43	17	17	17	17	17	17	17	17	17	17	17	41	41	20	16	19	61	31	31	61	61	9	11	14	-1	-1	-1	-1	-1	-1	-1
-1	-1	-1	-1	-1	-1	-1	-1	-1	-1	18	18	18	18	18	18	18	49	42	43	41	20	16	32	32	16	16	11	13	-1	-1	-1	-1	-1	-1	-1	-1
-1	-1	-1	-1	-1	-1	-1	-1	-1	-1	-1	-1	-1	-1	-1	-1	-1	49	1	44	42	43	41	33	33	41	41	39	57	-1	-1	-1	-1	-1	-1	-1	-1
-1	-1	-1	-1	-1	-1	-1	-1	-1	-1	-1	-1	-1	-1	-1	-1	-1	49	1	1	1	44	42	42	42	42	42	1	56	-1	-1	-1	-1	-1	-1	-1	-1
-1	-1	-1	-1	-1	-1	-1	-1	-1	-1	-1	-1	-1	-1	-1	-1	-1	49	1	1	1	1	1	1	1	1	1	1	56	-1	-1	-1	-1	-1	-1	-1	-1
-1	-1	-1	-1	-1	-1	-1	-1	-1	-1	-1	-1	-1	-1	-1	-1	-1	49	1	1	1	1	1	1	1	1	1	1	56	-1	-1	-1	-1	-1	-1	-1	-1
-1	-1	-1	-1	-1	-1	-1	-1	-1	-1	-1	-1	-1	-1	-1	-1	-1	49	1	1	1	1	1	1	1	1	1	1	56	-1	-1	-1	-1	-1	-1	-1	-1
-1	-1	-1	-1	-1	-1	-1	-1	-1	-1	-1	-1	-1	-1	-1	-1	60	1	1	1	1	1	1	1	1	1	1	1	1	57	-1	-1	-1	-1	-1	-1	-1
-1	-1	-1	-1	-1	-1	-1	-1	-1	-1	-1	-1	-1	-1	-1	-1	49	1	1	1	1	1	1	1	1	1	1	1	1	56	-1	-1	-1	-1	-1	-1	-1
-1	-1	-1	-1	-1	-1	-1	-1	-1	-1	-1	-1	-1	-1	-1	60	1	1	1	1	1	1	1	1	1	1	1	1	1	56	-1	-1	-1	-1	-1	-1	-1
-1	-1	-1	-1	-1	-1	-1	-1	-1	-1	59	59	59	59	59	49	1	1	1	1	1	1	1	1	1	1	1	1	1	1	57	-1	-1	-1	-1	-1	-1
-1	-1	-1	-1	-1	-1	-1	-1	-1	-1	58	58	58	58	58	1	1	1	1	1	1	1	1	1	1	1	1	1	1	1	56	-1	-1	-1	-1	-1	-1
-1	-1	-1	-1	-1	-1	-1	-1	-1	-1	1	1	1	1	1	1	1	1	1	1	1	1	1	1	1	1	1	1	1	1	56	59	59	59	59	59	-1
-1	-1	-1	-1	-1	-1	-1	-1	-1	-1	1	1	1	1	1	1	1	1	1	1	1	1	1	1	1	1	1	1	1	1	1	58	58	58	58	58	-1
-1	-1	-1	-1	-1	-1	-1	-1	-1	-1	1	1	1	1	1	1	1	1	1	1	1	1	1	1	1	1	1	1	1	1	1	1	1	1	1	1	-1
-1	-1	-1	-1	-1	-1	-1	-1	-1	-1	1	1	1	1	1	1	1	1	1	1	1	1	1	1	1	1	1	1	1	1	1	1	1	1	1	1	-1
-1	-1	-1	-1	-1	-1	-1	-1	-1	-1	52	52	52	52	52	52	1	1	1	1	1	1	1	1	1	1	1	1	1	1	1	1	1	1	1	1	-1
-1	-1	-1	-1	-1	-1	-1	-1	-1	-1	53	53	53	53	53	53	49	1	1	1	1	1	1	1	1	1	1	1	1	1	1	1	1	1	1	1	-1
-1	-1	-1	-1	-1	-1	-1	-1	-1	-1	-1	-1	-1	-1	-1	-1	50	1	1	1	1	1	1	1	1	1	1	1	1	1	52	52	52	52	52	52	-1
-1	-1	-1	-1	-1	-1	-1	-1	-1	-1	-1	-1	-1	-1	-1	-1	51	49	1	1	1	1	1	1	1	1	1	1	52	54	53	53	53	53	53	53	-1
-1	-1	-1	-1	-1	-1	-1	-1	-1	-1	-1	-1	-1	-1	-1	-1	-1	50	52	52	52	52	52	52	52	52	52	54	53	55	-1	-1	-1	-1	-1	-1	-1
-1	-1	-1	-1	-1	-1	-1	-1	-1	-1	-1	-1	-1	-1	-1	-1	-1	-1	53	53	53	53	53	53	53	53	53	-1	-1	-1	-1	-1	-1	-1	-1	-1	-1
-1	-1	-1	-1	-1	-1	-1	-1	-1	-1	-1	-1	-1	-1	-1	-1	-1	-1	-1	-1	-1	-1	-1	-1	-1	-1	-1	-1	-1	-1	-1	-1	-1	-1	-1	-1	-1
